#
# Word list for the Stendhal conversation parser
# @author Martin Fuchs
#
# The list entries are in the following format:
#  WORD	 TYPE	[=NORMALIZED]	[PLURAL|VALUE]
#
# WORD is the word in lower case.
# NORMALIZED is used to specify the the base form.
# PLURAL is the pluralized form of the word for nouns and verbs.
# VALUE is used to specify the numeric equivalent of numeric expressions.
#
# TYPE is one of the following constants:
#
#  VER			verb
#  VER-GER		verb in gerund form
#  VER-CON		verb in conditional form
#  VER-NEG		verb in negated form
#
#  OBJ			object
#  OBJ-AMO		amount
#  OBJ-FLU		fluid
#  OBJ-FOO		food
#  OBJ-OBS		obsessional word
#  OBJ-PRO		pronoun
#
#  SUB			subject
#  SUB-ANI		animal
#  SUB-NAM		person name
#  SUB-PRO		personal pronoun
#
#  ADJ			adjective/adverb
#  ADJ-COL		color expressions
#
#  NUM			numeral
#  PRE			preposition
#  QUE			question word
#  IGN			word to ignore
#

:)	VER	=smile
:*	VER	=kiss
:-)	VER	=smile
abort	VER
adios	VER
advertise	VER
appear	VER
ask	VER	=say
bail	VER
bake	VER
believe	VER
boo	VER
borrow	VER
buy	VER
bye	VER
care	VER
cast	VER
cheers	VER
cleanme	VER
close	VER
concoct	VER
cya	VER
did	VERB	=do
disembark	VER
do	VER
does	VER	=do
doesn't	VER-NEG	=do
don't	VER
done	VERB	=do
dressed	VER
drop	VER
eat	VER
embark	VER
engage	VER
exchange	VER
exit	VER
explain	VER
explore	VER
farewell	VER
fight	VER
fill	VER
fit	VER
flee	VER
gamble	VER
get	VER
give	VER
go	VER
gone	VER	=go
greetings	VER
had	VER	=have
hallo	VER	=hello
has	VER	=have
have	VER
heal	VER
hello	VER
hi	VER	=hello
hola	VER	=hello
hold	VER
is	VER	are
jump	VER
kill	VER
kiss	VER
laugh	VER
learn	VER
leave	VER
like	VER
look	VER
love	VER
made	VER	=make
make	VER
married	VER	=marry
marry	VER
may	VER-CON
mix	VER
not	VER-NEG
ok	VER
open	VER
overcook	VER
own	VER
play	VER
protect	VER
put	VER
rain	VER
reserve	VER
return	VER
revive	VER
run	VER
say	VER
sell	VER
sew	VER
shout	VER
sit	VER
smell	VER
smile	VER
sorry	VER
speak	VER	=say
start	VER
summon	VER
take	VER
there's	VER
travel	VER
understand	VER
use	VER
wear	VER
went	VER	=go
will	VER
won't	VER-NEG
work	VER
would	VER-CON	=will
wouldn't	VER-CON-NEG	=won't
yay	VER	=done
yes	VER

ados	OBJ	ados
alga	OBJ	algae
analysis	OBJ	analyses
antidote	OBJ	antidotes
apple	OBJ	apples
arandula	OBJ
armor	OBJ	armors
arrow	OBJ	arrows
arundula	OBJ	arundulas
athor	OBJ	athors
axe	OBJ	axes
ayuda	OBJ	ayudas
bag	OBJ	bags
bakery	OBJ	bakeries
banana	OBJ-FOO	bananas
bank	OBJ	banks
bar	OBJ	bars
bardiche	OBJ	bardiches
basement	OBJ	basements
battle	OBJ	battles
bean	OBJ-FOO	beans
beer	OBJ-FLU
blackjack	OBJ	blackjacks
blood	OBJ	bloods
board	OBJ	boards
body	OBJ	bodies
bone	OBJ	bones
book	OBJ	books
boot	OBJ	boots
bottle	OBJ	bottles
bow	OBJ	bows
box	OBJ	boxes
brandy	OBJ-FLU	brandies
bread	OBJ
bribe	OBJ	bribes
broadsword	OBJ	broadswords
broccoli	OBJ-FOO	broccolis
bronze	OBJ	bronzes
buckler	OBJ	bucklers
bureau	OBJ	bureaux
bush	OBJ	bushes
button	OBJ	buttons
caboose	OBJ	cabooses
car	OBJ	cars
carbuncle	OBJ	carbuncles
carrot	OBJ-FOO	carrots
catacomb	OBJ	catacombs
cauliflower	OBJ	cauliflowers
chain	OBJ	chains
challenge	OBJ	challenges
channange	OBJ	channanges
chaos	OBJ	chaos
char	OBJ	chars
character	OBJ	characters
cheese	OBJ-FOO	cheeses
cherry	OBJ-FOO	cherries
chest	OBJ	chests
chips	OBJ-FOO	chips
chunk	OBJ	chunks
citizenship	OBJ	citizenships
claymore	OBJ	claymores
cloak	OBJ	cloaks
clock	OBJ	clocks
cloth	OBJ	cloths
club	OBJ	clubs
cocktail	OBJ-FLU	cocktails
cod	OBJ-FOO	cods
coffin	OBJ	coffins
colada	OBJ-FLU	coladas
collard	OBJ	collards
collection	OBJ	collections
commander	OBJ	commanders
cookie	OBJ-FOO	cookies
cost	OBJ	costs
coupon	OBJ	coupons
courgette	OBJ-FOO	courgettes
cream	OBJ	creams
creature	OBJ	creatures
crossbow	OBJ	crossbows
crown	OBJ	crowns
crustaceans	OBJ	crustaceans
cuirass	OBJ	cuirasses
dagger	OBJ	daggers
deal	OBJ	deals
deathmatch	OBJ	deathmatches
diamond	OBJ	diamonds
dice	OBJ	dice
dish	OBJ	dishes
divorce	OBJ	divorces
doll	OBJ	dolls
dress	OBJ	dresses
drink	OBJ-FLU	drinks
earth	OBJ	earths
eater	OBJ	eaters
elemental	OBJ	elementals
emerald	OBJ	emeralds
entrail	OBJ	entrails
equipment	OBJ	equipments
erinys	OBJ	erinyes
eupepsia	OBJ	eupepsias
everything	OBJ	everythings
exam	OBJ	exams
eye	OBJ	eyes
faiumoni	OBJ	faiumonis
favor	OBJ	favors
favour	OBJ	favours
fee	OBJ	fees
ferry	OBJ	ferries
fire	OBJ	fires
fish	OBJ-FOO	fishes
flail	OBJ	flails
flask	OBJ	flasks
flour	OBJ	flours
flower	OBJ	flowers
food	OBJ-FOO	foods
foot	OBJ	feet
forge	OBJ	forges
gambling	OBJ	gamblings
gem	OBJ	gems
geography	OBJ	geographies
gnu	OBJ	gnus
goblet	OBJ	goblets
gold	OBJ	golds
gown	OBJ	gowns
gpl	OBJ	gpls
grain	OBJ-FOO	grains
group	OBJ	groups
halberd	OBJ	halberds
ham	OBJ	hams
hammer	OBJ	hammers
hand	OBJ	hands
hat	OBJ	hats
hatch	OBJ	hatches
helium	OBJ	helia
helm	OBJ	helms
helmet	OBJ	helmets
help	OBJ	helps
herb	OBJ	herbs
hint	OBJ	hints
history	OBJ	histories
home	OBJ	homes
honeymoon	OBJ	honeymoons
hospital	OBJ	hospitals
house	OBJ	houses
hypha	OBJ	hyphae
ice	OBJ	ices
index	OBJ	indices
ingredients	OBJ	ingredients
iron	OBJ	irons
island	OBJ	islands
it	OBJ-PRO	its
item	OBJ	items
job	OBJ	jobs
kanmararn	OBJ	kanmararns
karma	OBJ	karmas
katana	OBJ	katanas
kekik	OBJ	kekiks
key	OBJ	keys
kingdom	OBJ	kingdoms
knife	OBJ	knives
knight	OBJ	knights
kokuda	OBJ	kokudas
larva	OBJ	larvae
leek	OBJ-FOO	leeks
leg	OBJ	legs
level	OBJ	levels
library	OBJ	libraries
list	OBJ	lists
loaf	OBJ-AMO	loaves
log	OBJ	logs
longbow	OBJ	longbows
lotus	OBJ	lotuses
mace	OBJ	maces
machine	OBJ	machines
mackerel	OBJ	mackerels
magic	OBJ	magics
mainio	OBJ	mainios
map	OBJ	maps
match	OBJ	matches
matrix	OBJ	matrices
meat	OBJ	meats
medicine	OBJ	medicines
militia	OBJ	militias
mill	OBJ	mills
mistake	OBJ	mistakes
money	OBJ	money
moose	OBJ	moose
morning	OBJ	mornings
mouse	OBJ	mice
mumak	OBJ	mumakil
mushroom	OBJ-FOO	mushrooms
my	OBJ-OBS	mys
name	OBJ	names
naming	OBJ	namings
narwol	OBJ	narwols
news	OBJ	news
noose	OBJ	nooses
note	OBJ	notes
nothing	OBJ	nothings
nugget	OBJ	nuggets
obsidian	OBJ	obsidians
offer	OBJ	offers
onion	OBJ-FOO	onions
or'ril	OBJ	or'rils
ore	OBJ	ores
pair	OBJ	pairs
pan	OBJ	pans
paper	OBJ	papers
park	OBJ	parks
patch	OBJ	patches
pie	OBJ-FOO	pies
piece	OBJ	pieces
pina	OBJ	pinas
pinacolad	OBJ-FLU	=pinacolada	pinacoladas
pinacolada	OBJ-FLU	pinacoladas
pizza	OBJ-FOO	pizzas
places	OBJ	places
plan	OBJ	plans
plate	OBJ	plates
plural	OBJ	plurals
poison	OBJ-FLU	poisons
porcini	OBJ-FOO	porcini
portal	OBJ	portals
position	OBJ	positions
pot	OBJ	pots
potion	OBJ-FLU	potions
present	OBJ	presents
price	OBJ	prices
princess	OBJ	princesses
problem	OBJ	problems
quest	OBJ	quests
rainbow	OBJ	rainbows
request	OBJ	requests
restaurant	OBJ	restaurants
reward	OBJ	rewards
rhosyd	OBJ	rhosyds
ring	OBJ	rings
robin	OBJ	robins
rod	OBJ	rods
room	OBJ	rooms
rug	OBJ	rugs
sacerdotist	OBJ	sacerdotists
sack	OBJ-AMO	sacks
safety	OBJ	safeties
salad	OBJ	salads
sandwich	OBJ	sandwiches
sapphire	OBJ	sapphires
scale	OBJ	scales
scarlet	OBJ	scarlets
scimitar	OBJ	scimitars
sclaria	OBJ	sclarias
scroll	OBJ	scrolls
scythe	OBJ	scythes
secret	OBJ	secrets
security	OBJ	securities
semos	OBJ	semos
shadow	OBJ	shadows
sheaf	OBJ-AMO	sheaves
shield	OBJ	shields
shop	OBJ	shops
sign	OBJ	signs
silver	OBJ	silvers
skull	OBJ	skulls
slime	OBJ	slimes
sodium	OBJ	sodia
something	OBJ	somethings
soup	OBJ-FOO	soups
space	OBJ	spaces
species	OBJ	species
spinach	OBJ-FOO	spinaches
sprig	OBJ-AMO	sprigs
sps	OBJ	sps
staff	OBJ	staffs
stake	OBJ	stakes
star	OBJ	stars
status	OBJ	stati
steel	OBJ	steels
stendhal	OBJ	stendhals
stone	OBJ	stones
storage	OBJ	storages
story	OBJ	stories
suit	OBJ-AMO	suits
sun	OBJ	suns
suntan	OBJ	suntans
supplie	OBJ	supplies
sword	OBJ	swords
table	OBJ	tables
task	OBJ	tasks
taste	OBJ	tastes
tavern	OBJ	taverns
tea	OBJ-FLU	teas
teddy	OBJ	teddies
temple	OBJ	temples
that	OBJ	=this	this
these	OBJ	theses
this	OBJ	this
toadstool	OBJ	toadstools
token	OBJ	tokens
tomato	OBJ-FOO	tomatoes
tool	OBJ	tools
tooth	OBJ	teeth
town	OBJ	towns
toy	OBJ	toys
trade	OBJ	trades
trading	OBJ	tradings
treasure	OBJ	treasures
trigger	OBJ	triggers
trophy	OBJ	trophies
trouser	OBJ	trousers
trust	OBJ	trusts
venom	OBJ	venoms
vertex	OBJ	vertices
victory	OBJ	victories
village	OBJ	villages
vodka	OBJ-FLU	vodkas
vortex	OBJ	vortices
war	OBJ	wars
water	OBJ-FLU	waters
weapon	OBJ	weapons
wedding	OBJ	weddings
whiskey	OBJ-FLU	whiskeys
wikipedia	OBJ	wikipedias
wine	OBJ-FLU
wodka	OBJ-FLU	wodkas
wood	OBJ	woods
word	OBJ	words
world	OBJ	worlds
xeno	OBJ	xenos
yclept	OBJ	yclepts
youngster	OBJ	youngsters
your	OBJ-OBS	yours

archer	SUB	archers
archmage	SUB	archmages
archrat	SUB-ANI	archrats
baby	SUB	babies
bat	SUB-ANI	bats
bear	SUB-ANI	bears
beholder	SUB	beholders
ben	SUB-NAM
blacksmith	SUB
boar	SUB-ANI	boars
bob	SUB-NAM
boss	SUB	bosses
boy	SUB	boys
cat	SUB-ANI	cats
caverat	SUB-ANI	caverats
ceryl	SUB-NAM
charles	SUB-NAM
chicken	SUB-ANI	chickens
chief	SUB	chiefs
child	SUB	children
citizen	SUB
clownfish	SUB-ANI
cobra	SUB-ANI	cobras
crab	SUB-ANI	crabs
cyclops	SUB	cyclopses
death	SUB	deaths
demon	SUB	demons
deniran	SUB-NAM
deus	SUB	dei
djinni	SUB	djinn
dog	SUB-ANI	dogs
dragon	SUB-ANI	dragons
dwarf	SUB	dwarves
efreeti	SUB	efreet
elephant	SUB-ANI	elephants
elf	SUB	elves
felina	SUB-NAM
fox	SUB-ANI	foxes
gargoyle	SUB	gargoyles
ghost	SUB	ghosts
giant	SUB
giantrat	SUB-ANI	giantrats
gnome	SUB	gnomes
goblin	SUB	goblins
god	SUB
golem	SUB	golems
goose	SUB-ANI	geese
goran	SUB-NAM
guard	SUB
guardian	SUB	guardians
hayunn	SUB-NAM
he	SUB-PRO	they
heart	SUB
hero	SUB	heros
hugo	SUB-NAM
human	SUB	humans
hunter	SUB	hunters
i	SUB-PRO	we
idea	SUB
io	SUB-NAM
iou	SUB-NAM
javier	SUB-NAM
jynath	SUB-NAM
katinka	SUB-NAM
kobold	SUB	kobolds
kymara	SUB-NAM
leader	SUB	leaders
lich	SUB	liches
lifeguard	SUB
lion	SUB-ANI	lions
lord	SUB
mage	SUB	mages
man	SUB	men
margaret	SUB-NAM
mark	SUB-NAM
mary	SUB-NAM
me	SUB-PRO	=i	us
monkey	SUB	monkeys
mummy	SUB	mummies
nomad	SUB
noone	SUB
ogre	SUB	ogres
orc	SUB	orcs
parrot	SUB-ANI
penguin	SUB-ANI	penguins
perch	SUB-ANI
peter	SUB-NAM
pirate	SUB
player	SUB	players
rat	SUB-ANI	rats
ratman	SUB	ratmen
ratwoman	SUB	ratwomen
razorrat	SUB-ANI	razorrats
roach	SUB-ANI
sally	SUB-NAME
she	SUB-PRO	they
siandra	SUB-NAM
skeleton	SUB	skeletons
soldier	SUB	soldiers
sorcerer	SUB
spirit	SUB	spirits
surgeonfish	SUB-ANI
susi	SUB-NAM
them	SUB
thing	SUB
thonatus	SUB-NAM
tiger	SUB-ANI	tigers
tom	SUB-NAM
troll	SUB	trolls
trout	SUB-ANI
unicorn	SUB-ANI	unicorns
vampire	SUB
vegetarian	SUB	vegetarians
venomrat	SUB-ANI	venomrats
veteran	SUB	veterans
viking	SUB	vikings
warrior	SUB	warriors
wizard	SUB
wolf	SUB-ANI	wolves
woman	SUB	women
wumpus	SUB	wumpuses
xin	SUB-NAM
you	SUB-PRO	you
zak	SUB-NAM
zombie	SUB	zombies
zynn	SUB-NAM

another	ADJ
bad	ADJ
big	ADJ
biggest	ADJ
biting	ADJ
black	ADJ-COL
blue	ADJ-COL
brown	ADJ-COL
complete	ADJ
deadly	ADJ
devout	ADJ
dwarven	ADJ
elder	ADJ
elvish	ADJ
empty	ADJ
exact	ADJ
exotic	ADJ
fiscal	ADJ
fishy	ADJ
free	ADJ
fresh	ADJ
golden	ADJ-COL
good	ADJ
great	ADJ
greater	ADJ
greaterthan	ADJ
green	ADJ-COL
holy	ADJ
lazy	ADJ
leather	ADJ
lessthan	ADJ
magical	ADJ
markable	ADJ
marked	ADJ
mega	ADJ
minor	ADJ
missing	ADJ
nice	ADJ
nomadic	ADJ
old	ADJ
quick	ADJ
rare	ADJ
red	ADJ-COL
royal	ADJ
short	ADJ
silvery	ADJ-COL
small	ADJ
special	ADJ
studded	ADJ
tasty	ADJ
true	ADJ
twoside	ADJ
well	ADJ	=good
white	ADJ-COL
wooden	ADJ
young	ADJ

a	NUM	1
an	NUM	1
eight	NUM	8
eighteen	NUM	18
eighty	NUM	80
eleven	NUM	11
fifteen	NUM	15
fifty	NUM	50
first	NUM	1
five	NUM	5
four	NUM	4
fourteen	NUM	14
fourty	NUM	40
hundred	NUM	100
million	NUM	1000000
nine	NUM	9
nineteen	NUM	19
ninety	NUM	90
no	NUM	0
one	NUM	1
second	NUM	2
seven	NUM	7
seventeen	NUM	17
seventy	NUM	70
six	NUM	6
sixteen	NUM	16
sixty	NUM	60
ten	NUM	10
third	NUM	3
thirteen	NUM	13
thirty	NUM	30
thousand	NUM	1000
three	NUM	3
twelve	NUM	12
twenty	NUM	20
two	NUM	2
zero	NUM	0

about	PRE
down	PRE
for	PRE
in	PRE
of	PRE
off	PRE
on	PRE
over	PRE
somewhere	PRE
under	PRE
up	PRE
with	PRE

how	QUE
if	QUE
why	QUE

always	IGN
but	IGN
even	IGN
please	IGN
really	IGN
so	IGN
the	IGN
to	IGN
whatever	IGN

